Austria	Iceland	Iceland 
Belgium	Sweden	Belgium
Croatia	Spain	Croatia 
Czech Republic	Turkey	Turkey 
England	Slovakia	Draw
Germany	Northern Ireland	Germany
Hungary	Portugal	Draw
Iceland	Austria	Iceland
Italy	Republic of Ireland	Republic of Ireland
Northern Ireland	Germany	Germany
Poland	Ukraine	Poland
Portugal	Hungary	Draw
Republic of Ireland	Italy	Republic of Ireland
Russia	Wales	Wales
Slovakia	England	Draw
Spain	Croatia	Croatia
Sweden	Belgium	Belgium
Turkey	Czech Republic	Turkey
Ukraine	Poland	Poland
Wales	Russia	Wales
